8 2 1 6 8 5 3 8
8 8 2 3 7 3 4 3
4 5 6 3 6 1 5 2
7 7 5 4 1 1 2 6
1 6 4 7 2 4 5 1
1 3 4 6 5 7 7 8
5 4 4 8 2 7 6 5
3 2 7 2 4 7 1 5